{
  "Maps": [
    {
      "Name": "Symmetric Map 20 - Modified",
      "Grid": [
        ["E", "E", "E", "E", "E", "E", "D", "B", "D", "E", "E", "D", "B", "D", "E", "E", "E", "E", "E", "E"],
        ["E", "D", "E", "D", "B", "E", "E", "B", "E", "B", "B", "E", "B", "E", "E", "D", "E", "D", "E", "D"],
        ["E", "E", "B", "E", "E", "E", "D", "B", "D", "D", "B", "D", "E", "E", "E", "B", "E", "E", "E", "E"],
        ["E", "D", "E", "D", "B", "E", "E", "B", "E", "B", "B", "E", "B", "E", "E", "D", "E", "D", "E", "D"],
        ["E", "B", "E", "E", "E", "B", "E", "B", "E", "B", "E", "B", "E", "E", "E", "B", "E", "E", "B", "E"],
        ["E", "E", "E", "E", "E", "D", "B", "E", "E", "B", "B", "E", "B", "D", "E", "E", "E", "E", "E", "E"],
        ["D", "E", "E", "D", "B", "B", "E", "E", "E", "E", "E", "E", "E", "B", "B", "D", "E", "E", "D", "E"],
        ["B", "B", "D", "E", "E", "E", "E", "B", "E", "E", "B", "E", "E", "E", "E", "D", "B", "B", "E", "B"],
        ["D", "E", "B", "E", "B", "E", "B", "D", "E", "E", "B", "E", "E", "B", "E", "B", "E", "D", "B", "E"],
        ["E", "B", "D", "E", "E", "B", "E", "E", "D", "E", "E", "E", "E", "E", "B", "E", "E", "B", "E", "D"],
        ["E", "B", "D", "E", "E", "B", "E", "E", "E", "E", "E", "E", "E", "D", "E", "B", "E", "E", "B", "E"],
        ["D", "E", "B", "E", "B", "E", "B", "E", "E", "D", "B", "E", "B", "E", "B", "E", "D", "B", "E", "D"],
        ["B", "B", "D", "E", "E", "E", "E", "B", "E", "E", "B", "E", "E", "E", "E", "D", "B", "B", "E", "B"],
        ["D", "E", "E", "D", "B", "B", "E", "E", "E", "E", "E", "E", "E", "B", "B", "D", "E", "E", "D", "E"],
        ["E", "E", "E", "E", "E", "D", "B", "E", "E", "B", "B", "E", "B", "D", "E", "E", "E", "E", "E", "E"],
        ["E", "B", "E", "E", "E", "B", "E", "B", "E", "B", "E", "B", "E", "E", "E", "B", "E", "E", "B", "E"],
        ["E", "D", "E", "D", "E", "E", "E", "E", "E", "E", "E", "E", "E", "E", "D", "E", "D", "E", "D", "E"],
        ["E", "E", "B", "E", "E", "E", "D", "B", "D", "D", "B", "D", "E", "E", "E", "B", "E", "E", "E", "E"],
        ["E", "D", "E", "D", "B", "E", "E", "B", "E", "B", "B", "E", "B", "E", "E", "D", "E", "D", "E", "D"],
        ["E", "E", "E", "E", "E", "E", "D", "B", "D", "E", "E", "D", "B", "D", "E", "E", "E", "E", "E", "E"]
      ]
    }
  ]
}
