{
  "Maps": [
    {
      "Name": "Map 1",
      "Grid":[
        ["E","E","E","E","E","E","E","E","E","E","E","E","E","E","E","E","E","E","E","E"],
        ["E","D","E","D","B","E","E","E","E","E","E","E","E","E","E","E","E","E","E","E"],
        ["E","E","B","E","E","E","E","E","E","E","E","E","E","E","E","E","E","E","E","E"],
        ["E","D","E","D","E","E","E","E","E","E","E","E","E","E","E","E","E","E","E","E"],
        ["E","B","E","E","E","E","E","E","E","E","E","E","E","E","E","E","E","E","E","E"],
        ["E","E","E","E","E","E","E","E","E","E","E","E","E","E","E","E","E","E","E","E"],
        ["E","E","E","E","E","E","E","E","E","E","E","E","E","E","E","E","E","E","E","E"],
        ["E","E","E","E","E","E","E","E","E","E","E","E","E","E","E","E","E","E","E","E"],
        ["E","E","E","E","E","E","E","E","E","E","E","E","E","E","E","E","E","E","E","E"],
        ["E","E","E","E","E","E","E","E","E","E","E","E","E","E","E","E","E","E","E","E"],
        ["E","E","E","E","E","E","E","E","E","E","E","E","E","E","E","E","E","E","E","E"],
        ["E","E","E","E","E","E","E","E","E","E","E","E","E","E","E","E","E","E","E","E"],
        ["E","E","E","E","E","E","E","E","E","E","E","E","E","E","E","E","E","E","E","E"],
        ["E","E","E","E","E","E","E","E","E","E","E","E","E","E","E","E","E","E","E","E"],
        ["E","E","E","E","E","E","E","E","E","E","E","E","E","E","E","E","E","E","E","E"],
        ["E","E","E","E","E","E","E","E","E","E","E","E","E","E","E","E","E","E","E","E"],
        ["E","E","E","E","E","E","E","E","E","E","E","E","E","E","E","E","E","E","E","E"],
        ["E","E","E","E","E","E","E","E","E","E","E","E","E","E","E","E","E","E","E","E"],
        ["E","E","E","E","E","E","E","E","E","E","E","E","E","E","E","E","E","E","E","E"],
        ["E","E","E","E","E","E","E","E","E","E","E","E","E","E","E","E","E","E","E","E"]
      ]
    }
  ]
}
