{
  "Maps": [
    {
      "Name": "Map 1",
      "Grid": [
        ["E","E","B","E","E","E","E","B","E","E","E","E","B","E","E","E","B","E","E","E"],
        ["E","D","E","D","E","D","E","D","E","D","E","D","E","D","E","D","E","D","E","D"],
        ["E","E","B","E","E","E","B","E","E","E","B","E","E","E","B","E","E","E","B","E"],
        ["E","D","E","D","E","D","E","D","E","D","E","D","E","D","E","D","E","D","E","D"],
        ["E","E","E","E","B","E","E","E","B","E","E","E","B","E","E","E","B","E","E","E"],
        ["E","D","E","D","E","D","E","D","E","D","E","D","E","D","E","D","E","D","E","D"],
        ["E","E","B","E","E","E","B","E","E","E","B","E","E","E","B","E","E","E","B","E"],
        ["E","D","E","D","E","D","E","D","E","D","E","D","E","D","E","D","E","D","E","D"],
        ["E","E","E","E","B","E","E","E","B","E","E","E","B","E","E","E","B","E","E","E"],
        ["E","D","E","D","E","D","E","D","E","D","E","D","E","D","E","D","E","D","E","D"],
        ["E","E","B","E","E","E","B","E","E","E","B","E","E","E","B","E","E","E","B","E"],
        ["E","D","E","D","E","D","E","D","E","D","E","D","E","D","E","D","E","D","E","D"],
        ["E","E","E","E","B","E","E","E","B","E","E","E","B","E","E","E","B","E","E","E"],
        ["E","D","E","D","E","D","E","D","E","D","E","D","E","D","E","D","E","D","E","D"],
        ["E","E","B","E","E","E","B","E","E","E","B","E","E","E","B","E","E","E","B","E"],
        ["E","D","E","D","E","D","E","D","E","D","E","D","E","D","E","D","E","D","E","D"],
        ["E","E","E","E","B","E","E","E","B","E","E","E","B","E","E","E","B","E","E","E"],
        ["E","D","E","D","E","D","E","D","E","D","E","D","E","D","E","D","E","D","E","D"],
        ["E","E","B","E","E","E","B","E","E","E","B","E","E","E","B","E","E","E","B","E"],
        ["E","D","E","D","E","D","E","D","E","D","E","D","E","D","E","D","E","D","E","D"]
      ]
    }
  ]
}