{
  "maps": [
    {
      "name": "Map 1",
      "grid":[
        ["E","E","E","E","E","E","E","E","E","E","E","E","E","E","E","E","E","E","E","E"],
        ["E","U","E","U","B","E","E","E","E","E","E","E","E","E","E","E","E","E","E","E"],
        ["E","E","B","E","E","E","E","E","E","E","E","E","E","E","E","E","E","E","E","E"],
        ["E","U","E","U","E","E","E","E","E","E","E","E","E","E","E","E","E","E","E","E"],
        ["E","B","E","E","E","E","E","E","E","E","E","E","E","E","E","E","E","E","E","E"],
        ["E","E","E","E","E","E","E","E","E","E","E","E","E","E","E","E","E","E","E","E"],
        ["E","E","E","E","E","E","E","E","E","E","E","E","E","E","E","E","E","E","E","E"],
        ["E","E","E","E","E","E","E","E","E","E","E","E","E","E","E","E","E","E","E","E"],
        ["E","E","E","E","E","E","E","E","E","E","E","E","E","E","E","E","E","E","E","E"],
        ["E","E","E","E","E","E","E","E","E","E","E","E","E","E","E","E","E","E","E","E"],
        ["E","E","E","E","E","E","E","E","E","E","E","E","E","E","E","E","E","E","E","E"],
        ["E","E","E","E","E","E","E","E","E","E","E","E","E","E","E","E","E","E","E","E"],
        ["E","E","E","E","E","E","E","E","E","E","E","E","E","E","E","E","E","E","E","E"],
        ["E","E","E","E","E","E","E","E","E","E","E","E","E","E","E","E","E","E","E","E"],
        ["E","E","E","E","E","E","E","E","E","E","E","E","E","E","E","E","E","E","E","E"],
        ["E","E","E","E","E","E","E","E","E","E","E","E","E","E","E","E","E","E","E","E"],
        ["E","E","E","E","E","E","E","E","E","E","E","E","E","E","E","E","E","E","E","E"],
        ["E","E","E","E","E","E","E","E","E","E","E","E","E","E","E","E","E","E","E","E"],
        ["E","E","E","E","E","E","E","E","E","E","E","E","E","E","E","E","E","E","E","E"],
        ["E","E","E","E","E","E","E","E","E","E","E","E","E","E","E","E","E","E","E","E"]
      ]
    }
  ]
}